%%%%%%%%%%%%%%%%%%%%
%......%....%......%
%.%%...%%..%%...%%.%
%.%..%........%..%.%
%.%%.%.%%%%%%.%.%%.%
%........P.........%
%%%%%%%%%%%%%%%%%%%%
