%%%%%%%%%%%%%%%%%%%%
%.....P...%........%
%%%.%%.%%%.%%%.%%..%
%...%...%.......%..%
%%%.%.%%%.%%%%%..%.%
%.........%........%
%%%%%%%%%%%%%%%%%%%%
