%%%%%%%%%%%%%%%%%%%%
%..................%
%%%.%.%%%%.%%%%.%%%%
%.....%.....%.....%%
%.%.%.%%.%%.%..%%.%%
%P..%...%...%...%..%
%%%%%%%%%%%%%%%%%%%%
