%%%%%%%%%%%%%%%%%%%%
%............P.....%
%%%.%..%%%%.%%%...%%
%...%...%...%...%..%
%..%%%.%%.%%%.%%%%.%
%...%...%...%...%..%
%%%%%%%%%%%%%%%%%%%%
