%%%%%%%%%%%%%%%%%%%%
%.........%........%
%%.%%.%.%%%.%%%.%%.%
%P...%.........%...%
%%.%.%%%%.%.%%.%.%%%
%.........%........%
%%%%%%%%%%%%%%%%%%%%
