%%%%%%%%%%%%%%%%%%%%
%....%....%....%...%
%%.%%P.%%%%.%%%.%.%%
%..................%
%..%%.%%%.%%%.%%%.%%
%...%...%...%...%..%
%%%%%%%%%%%%%%%%%%%%
