%%%%%%%%%%%%%%%%%%%%
%.........%........%
%%%.%%.%%%%.%%%%%%%%
%P.................%
%.%%%%.%%%%%%.%%%%.%
%....%....%....%...%
%%%%%%%%%%%%%%%%%%%%
