%%%%%%%%%%%%%%%%%%%%
%....%.........%...%
%%.%.%%%..%%%..%%%.%
%....%....%....%...%
%%.%%%.%%.%..%%%%.%%
%.........%..P.....%
%%%%%%%%%%%%%%%%%%%%
