%%%%%%%%%%%%%%%%%%%%
%.....%.....%.....%%
%%%%%.%%%%..%%%.%%%%
%..................%
%%.%%%%.%%%%.%%%%%%%
%.........%..P.....%
%%%%%%%%%%%%%%%%%%%%
