%%%%%%%%%%%%%%%%%%%%
%...%...%...%...%..%
%.%.%.%%.%.%%%.%%..%
%....P%.....%.....%%
%%%.%%%.%%.%%%%.%%%%
%..................%
%%%%%%%%%%%%%%%%%%%%
