%%%%%%%%%%%%%%%%%%%%
%.....P...%........%
%%%.%%.%%%.%%%.%%..%
%...%...%...%...%..%
%%%.%.%%%.%%%%%..%.%
%.........%........%
%%%%%%%%%%%%%%%%%%%%
