%%%%%%%%%%%%%%%%%%%%
%.....%.....%.....%%
%%%%.%.%%.%%%%%%%..%
%.........%........%
%%%.%%%.%%%%%.%%%%%%
%.................P%
%%%%%%%%%%%%%%%%%%%%