%%%%%%%%%%%%%%%%%%%%
%.........%....%...%
%..%%.%%%.%%%%.%.%.%
%...%...%...%P..%..%
%..%%.%%%.%.%%..%%.%
%....%....%....%...%
%%%%%%%%%%%%%%%%%%%%