%%%%%%%%%%%%%%%%%%%%
%..P%...%...%...%..%
%%.%%%.%%.%%.%%.%.%%
%..................%
%%%.%%%%%.%%%.%%%%%%
%.....%.....%.....%%
%%%%%%%%%%%%%%%%%%%%