%%%%%%%%%%%%%%%%%%%%
%.....%.....%.....%%
%%%%.%%%%%%.%%.%%%.%
%..................%
%%.%%%%%%%%%%%%%%P%%
%..................%
%%%%%%%%%%%%%%%%%%%%