%%%%%%%%%%%%%%%%%%%%
%....%P...%....%...%
%%.%%%%.%%%.%%.%%%.%
%.....%.....%.....%%
%.%.%.%%%%.%%%%.%..%
%...%.......%...%..%
%%%%%%%%%%%%%%%%%%%%