%%%%%%%%%%%%%%%%%%%%
%..................%
%%%%%.%%..%%%%%.%%%%
%.....%.....%.....%%
%.%.%%.%..%%%%%.%..%
%...%...%...%...%P.%
%%%%%%%%%%%%%%%%%%%%