%%%%%%%%%%%%%%%%%%%%
%...%...%...%.P.%..%
%.%.%.%%%..%%%%.%..%
%...%...%.......%..%
%.%.%%%.%%..%%..%..%
%...%.......%...%..%
%%%%%%%%%%%%%%%%%%%%