%%%%%%%%%%%%%%%%%%%%
%..................%
%%%%.%%%%P%.%.%%%.%%
%....%....%....%...%
%%%%.%.%%%%%%.%.%.%%
%..................%
%%%%%%%%%%%%%%%%%%%%