%%%%%%%%%%%%%%%%%%%%
%.....P............%
%.%.%%%%%.%.%%%%.%%%
%....%....%....%...%
%%.%.%%%%.%%%.%%%.%%
%.........%........%
%%%%%%%%%%%%%%%%%%%%