%%%%%%%%%%%%%%%%%%%%
%....%....%.P..%...%
%%.%.%.%%%%.%%%%%%.%
%.........%........%
%%%.%%.%%%%%%%%.%%%%
%..................%
%%%%%%%%%%%%%%%%%%%%