%%%%%%%%%%%%%%%%%%%%
%....%....%....%...%
%%%.%%.%.%%%%%.%%..%
%.....%.....%..P..%%
%%%.%%%..%%%%..%.%%%
%....%....%....%...%
%%%%%%%%%%%%%%%%%%%%