%%%%%%%%%%%%%%%%%%%%
%..................%
%.%%%%%%%%.%%%%%%%%%
%P.................%
%..%%.%%%.%%%%%.%.%%
%...%...%...%...%..%
%%%%%%%%%%%%%%%%%%%%