%%%%%%%%%%%%%%%%%%%%
%...%...%...%...%..%
%..%%%%.%%%.%%..%%.%
%..P......%........%
%..%%%%%%%%%.%%%%%%%
%.........%........%
%%%%%%%%%%%%%%%%%%%%