%%%%%%%%%%%%%%%%%%%%
%.........%........%
%.%%%%%.%.%%%..%.%%%
%....%....%....%P..%
%.%%.%%.%%.%%.%%.%.%
%...%...%...%...%..%
%%%%%%%%%%%%%%%%%%%%