%%%%%%%%%%%%%%%%%%%%
%....%.........%...%
%%%..%.%.%%..%%%%%.%
%....%....%....%...%
%%.%%%%.%%%.%%%%.%.%
%.......P.%........%
%%%%%%%%%%%%%%%%%%%%