%%%%%%%%%%%%%%%%%%%%
%.....%..P..%.....%%
%%%%.%%.%%.%%%.%.%%%
%..................%
%%%.%%%%%.%%%.%.%%%%
%.........%........%
%%%%%%%%%%%%%%%%%%%%