%%%%%%%%%%%%%%%%%%%%
%....%....%..P.%...%
%%.%%..%%%%%%%.%%%.%
%.........%........%
%%%%%%%%%.%.%%%%%%.%
%..................%
%%%%%%%%%%%%%%%%%%%%