%%%%%%%%%%%%%%%%%%%%
%...%...%...%...%..%
%%..%.%%%.%%%%.%%..%
%.........%........%
%%%.%%%%%%%%%%%%.%.%
%..........P.......%
%%%%%%%%%%%%%%%%%%%%