%%%%%%%%%%%%%%%%%%%%
%....P.............%
%%.%%%.%%%.%%%.%%%.%
%...%...%...%...%..%
%%..%.%%%.%.%.%%%%.%
%...%...%...%...%..%
%%%%%%%%%%%%%%%%%%%%