%%%%%%%%%%%%%%%%%%%%
%...%.......%...%..%
%%.%%%.%%%%..%.%%.%%
%........P%........%
%%.%%%%%%.%%%%%..%%%
%.........%........%
%%%%%%%%%%%%%%%%%%%%