%%%%%%%%%%%%%%%%%%%%
%..................%
%%%%%%%.%%%%%.%%%%.%
%.....P...%........%
%.%%%%.%%%..%%%%%.%%
%.....%.....%.....%%
%%%%%%%%%%%%%%%%%%%%