%%%%%%%%%%%%%%%%%%%%
%...%...%...%...%..%
%%%.%..%%%%.%%%.%%.%
%.........%........%
%.%%%.%.%%.%%%..%%.%
%...%...%...%..P%..%
%%%%%%%%%%%%%%%%%%%%