%%%%%%%%%%%%%%%%%%%%
%.....%P....%.....%%
%%..%%%%%.%%%.%.%%%%
%.........%........%
%%.%%%%%%%%%%%.%%%%%
%..................%
%%%%%%%%%%%%%%%%%%%%