%%%%%%%%%%%%%%%%%%%%
%.......%...%...%..%
%..%%%%.%.%%%%.%.%.%
%...P.%.....%......%
%.%%%.%.%%%.%.%%%..%
%....%....%....%...%
%%%%%%%%%%%%%%%%%%%%