%%%%%%%%%%%%%%%%%%%%
%....%....%....%...%
%..%%%%.%%%.%%..%%.%
%.....%.....%.....%%
%%%..%%%%.%.P%%%..%%
%....%....%....%...%
%%%%%%%%%%%%%%%%%%%%