%%%%%%%%%%%%%%%%%%%%
%.....%.....%.....%%
%%%%%.%%.%%%%%.%.%%%
%..................%
%%%%.%%%%%%%%%%%%%.%
%.......P..........%
%%%%%%%%%%%%%%%%%%%%