%%%%%%%%%%%%%%%%%%%%
%.........%........%
%.%%%%%%%.%.%%%%.%%%
%.....%.....%.....%%
%%.%%.%%.%%%%%.%%%%%
%................P.%
%%%%%%%%%%%%%%%%%%%%