%%%%%%%%%%%%%%%%%%%%
%.......%...%...%..%
%.%.%%..%%..%.%.%%.%
%...%...%...%...%..%
%%%.%%P%.%%.%%..%..%
%....%....%....%...%
%%%%%%%%%%%%%%%%%%%%