%%%%%%%%%%%%%%%%%%%%
%....%.........%...%
%.%%%%%.%.%.%%%%%..%
%.....P...%........%
%.%.%%.%%.%%%%..%%.%
%...%...%...%...%..%
%%%%%%%%%%%%%%%%%%%%