%%%%%%%%%%%%%%%%%%%%
%...%...%...%...%..%
%..%%..%%..%%.%.%%.%
%...%..P%...%...%..%
%%..%.%.%.%.%%.%%..%
%....%....%....%...%
%%%%%%%%%%%%%%%%%%%%