%%%%%%%%%%%%%%%%%%%%
%..................%
%.%%%%%.%%%..%.%%%.%
%...%..P%...%...%..%
%.%.%%.%%.%.%.%%.%.%
%.....%.....%.....%%
%%%%%%%%%%%%%%%%%%%%