%%%%%%%%%%%%%%%%%%%%
%.........%P.......%
%%.%%%%.%.%%%%..%%%%
%.....%.....%.....%%
%%.%.%%%.%%.%%.%.%.%
%....%....%....%...%
%%%%%%%%%%%%%%%%%%%%