%%%%%%%%%%%%%%%%%%%%
%....%....%....%...%
%%%.%%.%%%%..%%%%%P%
%..................%
%%.%%%.%%%%.%%..%.%%
%...%...%...%...%..%
%%%%%%%%%%%%%%%%%%%%