%%%%%%%%%%%%%%%%%%%%
%.........%........%
%%%..%%%.%%%%%.%.%%%
%.....%...........%%
%%..%%%.%.%%%.%.%P%%
%...%...%...%...%..%
%%%%%%%%%%%%%%%%%%%%