%%%%%%%%%%%%%%%%%%%%
%....P%.....%.....%%
%%%.%.%..%.%%%%.%.%%
%...%...%...%...%..%
%%%.%%..%%%.%..%%%.%
%...%...%.......%..%
%%%%%%%%%%%%%%%%%%%%