%%%%%%%%%%%%%%%%%%%%
%.....%..P..%.....%%
%%.%%%%.%%%%%.%%%.%%
%.........%........%
%%%%%%.%%%%%%%%%%..%
%..................%
%%%%%%%%%%%%%%%%%%%%