%%%%%%%%%%%%%%%%%%%%
%..................%
%%%%%.%%%%%%%%.%%%%%
%..................%
%%%%%%%%%%%%%%%%%%.%
%.P................%
%%%%%%%%%%%%%%%%%%%%