%%%%%%%%%%%%%%%%%%%%
%.........%.P......%
%.%%.%%%%%%.%%%%%.%%
%...........%.....%%
%%%.%%%%%%.%..%%%%%%
%.........%........%
%%%%%%%%%%%%%%%%%%%%