%%%%%%%%%%%%%%%%%%%%
%..................%
%.%%.%%.%.%%%.%%%.%%
%...%...%...%...%P.%
%%..%%.%%..%%%.%%.%%
%.....%.....%.....%%
%%%%%%%%%%%%%%%%%%%%