%%%%%%%%%%%%%%%%%%%%
%....%....%....%...%
%.%%%%%%%.%.%%.%.%%%
%.........%........%
%%%%.%%..%%%%%%.%%.%
%.....%..P..%.....%%
%%%%%%%%%%%%%%%%%%%%