%%%%%%%%%%%%%%%%%%%%
%...%...%...%...%..%
%.%%%%P.%%..%.%.%%.%
%...%...%...%...%..%
%%..%.%%%.%.%.%%%.%%
%.....%.....%.....%%
%%%%%%%%%%%%%%%%%%%%