%%%%%%%%%%%%%%%%%%%%
%..................%
%.%.%%.%%%%.%%%.%.%%
%...%...%...%...%..%
%%.%%.%.%%..%.%.%..%
%...%P..%...%...%..%
%%%%%%%%%%%%%%%%%%%%