%%%%%%%%%%%%%%%%%%%%
%....%....%....%...%
%%%..%%%.%%.%%%%.%.%
%.....%.....%.....%%
%.%%.%%%%.%%%.%%%%.%
%.......P.%........%
%%%%%%%%%%%%%%%%%%%%