%%%%%%%%%%%%%%%%%%%%
%....%....%....%...%
%.%%%.%.%.%%.%%.%.%%
%.....%.....%.....%%
%%%.%.%%%.%P%.%%%%.%
%.........%....%...%
%%%%%%%%%%%%%%%%%%%%