%%%%%%%%%%%%%%%%%%%%
%.....%.....%.....%%
%.%%%.%.%%%.%%%%%.%%
%....%....%....%...%
%%%..%%%.%%%%.%%%..%
%.........%......P.%
%%%%%%%%%%%%%%%%%%%%