%%%%%%%%%%%%%%%%%%%%
%...%...%...%...%..%
%%%..%%.%%.%%.%%%%.%
%......P...........%
%%..%%.%%%%%%%.%.%.%
%....%....%....%...%
%%%%%%%%%%%%%%%%%%%%