%%%%%%%%%%%%%%%%%%%%
%.........%........%
%%..%.%%%%%.%.%%%%.%
%P..%.......%...%..%
%%.%%.%%.%%.%%.%%.%%
%.....%.....%.....%%
%%%%%%%%%%%%%%%%%%%%