%%%%%%%%%%%%%%%%%%%%
%.....%.....%.....%%
%.%.%%%%%%.%%%.%%%%%
%...P..............%
%.%%%%.%%%%%%%.%%.%%
%....%....%....%...%
%%%%%%%%%%%%%%%%%%%%