%%%%%%%%%%%%%%%%%%%%
%...%.......%...%..%
%.%%...%%%..%%%.%%.%
%...P%....%....%...%
%%%..%.%%.%.%.%%.%.%
%....%....%....%...%
%%%%%%%%%%%%%%%%%%%%