%%%%%%%%%%%%%%%%%%%%
%.........%........%
%%%%%%%..%%%%%.%.%%%
%.........%...P....%
%%%.%.%%%%%.%..%%%%%
%.....%.....%.....%%
%%%%%%%%%%%%%%%%%%%%