%%%%%%%%%%%%%%%%%%%%
%...%...%...%...%..%
%%.%.%%..%.%%%.%%%.%
%....%.........%.P.%
%%%.%%.%.%%%%.%%%.%%
%.........%........%
%%%%%%%%%%%%%%%%%%%%