%%%%%%%%%%%%%%%%%%%%
%...%...%...%...%..%
%.%.%%.%%%.%%%..%%.%
%.........%........%
%%%%.%%%%%%%.%%%%%.%
%.............P....%
%%%%%%%%%%%%%%%%%%%%