%%%%%%%%%%%%%%%%%%%%
%.....P............%
%%.%%%.%%.%.%%%%%%.%
%....%....%....%...%
%%%.%%%..%%%.%.%%..%
%....%....%....%...%
%%%%%%%%%%%%%%%%%%%%