%%%%%%%%%%%%%%%%%%%%
%...%...%...%...%..%
%%%..%%.%.%%%%%.%.%%
%.....%.....%.....%%
%%.%%%.%.%%%%%...%%%
%....%....%..P.%...%
%%%%%%%%%%%%%%%%%%%%