%%%%%%%%%%%%%%%%%%%%
%...........%...P.%%
%%%%.%.%%%..%.%%.%%%
%....%....%....%...%
%%.%%%..%%%.%%%%%.%%
%.........%........%
%%%%%%%%%%%%%%%%%%%%