%%%%%%%%%%%%%%%%%%%%
%............P.....%
%.%%%%%%.%%%%%.%%%%%
%.....%.....%.....%%
%.%%...%%%.%.%%%%..%
%....%....%....%...%
%%%%%%%%%%%%%%%%%%%%