%%%%%%%%%%%%%%%%%%%%
%.....%.....%.....%%
%%%.%.%%.%%.%..%%%%%
%.P...%.....%.....%%
%.%.%%%%%..%%.%%.%%%
%...........%.....%%
%%%%%%%%%%%%%%%%%%%%