%%%%%%%%%%%%%%%%%%%%
%....%....%....%...%
%..%%%%.%.%..%%%%%.%
%....%....%....%...%
%%.%%%%%.%%%.%%%%P%%
%..................%
%%%%%%%%%%%%%%%%%%%%