%%%%%%%%%%%%%%%%%%%%
%....%....%P...%...%
%%.%.%..%%%..%%%%.%%
%.........%....%...%
%%%..%%.%%%.%.%%%%.%
%...%.......%...%..%
%%%%%%%%%%%%%%%%%%%%