%%%%%%%%%%%%%%%%%%%%
%....%....%....%...%
%.%%.%%%%.%.%%...%%%
%....P%.....%.....%%
%%.%%.%%%.%%.%.%%%%%
%.........%........%
%%%%%%%%%%%%%%%%%%%%