%%%%%%%%%%%%%%%%%%%%
%....%....%....%...%
%%P%.%%%%.%.%.%%%%.%
%.....%.....%.....%%
%.%.%%%%%%.%%%%..%%%
%..................%
%%%%%%%%%%%%%%%%%%%%