%%%%%%%%%%%%%%%%%%%%
%...%...%...%...%..%
%%%.%.%.%%%.%%..%..%
%...%...%...%...%..%
%.%%%%%..%%.%.%..%.%
%....%....%....%..P%
%%%%%%%%%%%%%%%%%%%%