%%%%%%%%%%%%%%%%%%%%
%.....%.....%.P...%%
%.%%%.%%%%.%%.%.%%%%
%.........%........%
%%%.%.%%%.%%%..%%%.%
%...%...%.......%..%
%%%%%%%%%%%%%%%%%%%%