%%%%%%%%%%%%%%%%%%%%
%..................%
%%..%%%%%%%%%%%%%%%%
%..................%
%%%.%%%%%.%%%.%%%%.%
%...P%....%....%...%
%%%%%%%%%%%%%%%%%%%%