%%%%%%%%%%%%%%%%%%%%
%..................%
%%.%%%.%%%.%.%%%%%.%
%...P%....%....%...%
%.%.%%%%.%%%.%%%%.%%
%..................%
%%%%%%%%%%%%%%%%%%%%