%%%%%%%%%%%%%%%%%%%%
%P...%....%....%...%
%..%%%..%%%.%.%..%.%
%...%...%...%...%..%
%%.%%%%..%%...%%%.%%
%.........%........%
%%%%%%%%%%%%%%%%%%%%