%%%%%%%%%%%%%%%%%%%%
%...%...%...%...%..%
%.%%%%.%%%%.%%%.%.%%
%........P.........%
%%..%%%%.%%%%.%%%%%%
%.....%.....%.....%%
%%%%%%%%%%%%%%%%%%%%