%%%%%%%%%%%%%%%%%%%%
%.....%.....%.....%%
%%%.%.%%%.%%.%%.%%%%
%.........%........%
%%.%.%%%%%%%%%%%.%.%
%......P..%........%
%%%%%%%%%%%%%%%%%%%%