%%%%%%%%%%%%%%%%%%%%
%..................%
%%%%%%%%.%.%%%%%%%%%
%.P................%
%..%%%%%%%.%%%%%.%%%
%.....%.....%.....%%
%%%%%%%%%%%%%%%%%%%%