%%%%%%%%%%%%%%%%%%%%
%....%....%....%...%
%..%%%..%%%.%%%.%%.%
%...%...%.......%..%
%%P%.%.%.%%.%..%%.%%
%...........%.....%%
%%%%%%%%%%%%%%%%%%%%