%%%%%%%%%%%%%%%%%%%%
%..................%
%%%%%%%%.%%%%.%%%%.%
%.........%........%
%%%.P.%%%%.%.%.%%%.%
%...%...%...%...%..%
%%%%%%%%%%%%%%%%%%%%