%%%%%%%%%%%%%%%%%%%%
%....%....%....%...%
%.%%.%..%.%%%.%%%%.%
%...%...%...%...%..%
%%..%.%.%%..%.%.%%.%
%...%...%...%.P....%
%%%%%%%%%%%%%%%%%%%%