%%%%%%%%%%%%%%%%%%%%
%.....%.....%.....%%
%.%.%%.%%%..%.%.%%.%
%...%...%...%...%.P%
%%.%%%.%%%%..%.%%.%%
%.........%........%
%%%%%%%%%%%%%%%%%%%%