%%%%%%%%%%%%%%%%%%%%
%....%.........%...%
%.%%.%%.%.%.%%%%.%.%
%....%..P.%....%...%
%..%%%..%%%.%.%%.%.%
%...%...%...%...%..%
%%%%%%%%%%%%%%%%%%%%