%%%%%%%%%%%%%%%%%%%%
%..................%
%.%%%%.%%%%%.%%%%%.%
%.........%...P....%
%%%.%%..%.%%%.%%%..%
%...%...%...%...%..%
%%%%%%%%%%%%%%%%%%%%