%%%%%%%%%%%%%%%%%%%%
%...%...%...%...%..%
%%..%%..%.%%%..%%.%%
%...%...%...%...%..%
%%%.%..%%%P%%%.%%.%%
%..................%
%%%%%%%%%%%%%%%%%%%%