%%%%%%%%%%%%%%%%%%%%
%.....%.....%.....%%
%..%%.%%%.P%%.%%%%.%
%...%...%...%...%..%
%.%%%%.%%..%%.%%%%.%
%.........%........%
%%%%%%%%%%%%%%%%%%%%