%%%%%%%%%%%%%%%%%%%%
%.....%.....%......%
%%%.%.%%.%.%%P%.%%.%
%...%...%...%...%..%
%.%%%%%...%%%..%.%.%
%....%....%....%...%
%%%%%%%%%%%%%%%%%%%%