%%%%%%%%%%%%%%%%%%%%
%....%....%....%...%
%%%%..%%%.%..%.%%%.%
%.....%.....%.....%%
%%.%.%%.%%..%P%%.%%%
%....%....%....%...%
%%%%%%%%%%%%%%%%%%%%