%%%%%%%%%%%%%%%%%%%%
%.....%.....%.....%%
%.%%%%%%.%%%%%.%%%.%
%..................%
%%%%%%%.%%%%%%..%%%%
%P........%........%
%%%%%%%%%%%%%%%%%%%%