%%%%%%%%%%%%%%%%%%%%
%.....%.....%.....%%
%..%%%%.%%%%%.%%%%%%
%......P...........%
%.%%%%%%.%%%.%.%%%%%
%.....%.....%.....%%
%%%%%%%%%%%%%%%%%%%%