%%%%%%%%%%%%%%%%%%%%
%..................%
%.%%%.%%%.%%%..%%.%%
%....%....%....%...%
%.%%%%%%%.%%%.%%%%.%
%.P.......%........%
%%%%%%%%%%%%%%%%%%%%