%%%%%%%%%%%%%%%%%%%%
%.....%...........%%
%%%%.%%%.%%.%%%.%.%%
%.....%.....%.....%%
%%%%..%..%%%%.%%.%%%
%.....%.....%...P.%%
%%%%%%%%%%%%%%%%%%%%