%%%%%%%%%%%%%%%%%%%%
%.....%.....%.....%%
%%%..%%%.%%%%%.%%.%%
%.....%.....%P....%%
%..%%%..%%%.%.%%%.%%
%...%...%...%...%..%
%%%%%%%%%%%%%%%%%%%%