%%%%%%%%%%%%%%%%%%%%
%.....%...........%%
%.%.%.%%%.%%%%%.%.%%
%...%...%...%...%..%
%.%%%..%%%..%.%%%.%%
%.....%.....%P....%%
%%%%%%%%%%%%%%%%%%%%