%%%%%%%%%%%%%%%%%%%%
%.........%........%
%%%...%%%%%.%.%%%%.%
%P..%...%...%...%..%
%..%%.%%%..%%%%.%..%
%.....%.....%.....%%
%%%%%%%%%%%%%%%%%%%%