%%%%%%%%%%%%%%%%%%%%
%.........%........%
%%..%%%%%%%..%%%%.%%
%.....%...P.%.....%%
%..%%.%%%.%.%.%.%.%%
%...%.......%...%..%
%%%%%%%%%%%%%%%%%%%%