%%%%%%%%%%%%%%%%%%%%
%....%....%....%...%
%.%%%%.%%%%%.%%%%%.%
%..................%
%.%%%.%%%.%%%%%.%%.%
%...%...%...%P..%..%
%%%%%%%%%%%%%%%%%%%%