%%%%%%%%%%%%%%%%%%%%
%.........%....%...%
%%.%.%..%%%.%%%%%%.%
%....%....%....%...%
%%..%%.%.%%%%%.%.%.%
%....%..P.%....%...%
%%%%%%%%%%%%%%%%%%%%