%%%%%%%%%%%%%%%%%%%%
%.....%.....%.....%%
%%.%.%%%%.%.%%%.%%.%
%....%P...%....%...%
%.%.%%.%%%%%.%%%%%.%
%.........%........%
%%%%%%%%%%%%%%%%%%%%