%%%%%%%%%%%%%%%%%%%%
%...........%.....%%
%.%.%%%.%.%%%%.%.%%%
%.....%P....%.....%%
%%..%%.%%.%.%%..%.%%
%...%...%...%...%..%
%%%%%%%%%%%%%%%%%%%%