%%%%%%%%%%%%%%%%%%%%
%.P.......%........%
%.%%.%%.%%%.%%%.%%.%
%...%...%...%...%..%
%%.%%%.%%%..%%..%%.%
%.....%.....%.....%%
%%%%%%%%%%%%%%%%%%%%