%%%%%%%%%%%%%%%%%%%%
%....%....%....%...%
%%%.P%%.%%%%%%.%.%.%
%.........%........%
%%%%%%.%%%%%.%%%.%%%
%..................%
%%%%%%%%%%%%%%%%%%%%