%%%%%%%%%%%%%%%%%%%%
%.....%..P........%%
%%%%.%.%%.%%%%%%%..%
%.........%........%
%%%.%..%%%%..%.%%.%%
%...%...%...%...%..%
%%%%%%%%%%%%%%%%%%%%