%%%%%%%%%%%%%%%%%%%%
%.........%....%...%
%.%.%%.%%.%%.%%%%%.%
%....%....%....%...%
%..%%%%%%..%%%.%.%.%
%...P.%.....%.....%%
%%%%%%%%%%%%%%%%%%%%