%%%%%%%%%%%%%%%%%%%%
%.........%........%
%%%%.%%%%P%%%%%.%.%%
%.....%.....%.....%%
%.%.%%%%%%.%%%%%%.%%
%.....%.....%.....%%
%%%%%%%%%%%%%%%%%%%%