%%%%%%%%%%%%%%%%%%%%
%....%....%....%...%
%%%.%%..%%%.%%%%..%%
%....%....%....%...%
%.%.%%%.%%%.%%%..%%%
%.....P...%........%
%%%%%%%%%%%%%%%%%%%%