%%%%%%%%%%%%%%%%%%%%
%..................%
%%%%%.%%%.%%..%%%%%%
%.....%.....%.....%%
%%%.%..%%%.%%.%%%%.%
%...%P..%...%...%..%
%%%%%%%%%%%%%%%%%%%%