%%%%%%%%%%%%%%%%%%%%
%...%...%.......%.P%
%%%.%%.%%.%%%%.%%%.%
%.........%........%
%%.%%.%.%%%%%%.%..%%
%....%....%....%...%
%%%%%%%%%%%%%%%%%%%%