%%%%%%%%%%%%%%%%%%%%
%....%....%....%...%
%.%%%%%%.%%%%.%%%%.%
%..................%
%.%%%%%%%%%%%%.%.%%%
%.........%.P......%
%%%%%%%%%%%%%%%%%%%%