%%%%%%%%%%%%%%%%%%%%
%..................%
%%.%%%%%%.%%%%.%%%.%
%....%....%....%..P%
%%%.%%.%%%..%%%%%%.%
%..................%
%%%%%%%%%%%%%%%%%%%%
