%%%%%%%%%%%%%%%%%%%%
%..................%
%%.................%
%.................P%
%..................%
%..................%
%%%%%%%%%%%%%%%%%%%%
