%%%%%%%%%%%%%%%%%%%%
%..................%
%..................%
%.................P%
%..................%
%..................%
%%%%%%%%%%%%%%%%%%%%
