%%%%%%%%%%%%%%%%%%%%
%    %    %    %   %
% %%%%%% %%%% %%%% %
%                  %
% %%%%%%%%%%%% % %%%
%         % P.     %
%%%%%%%%%%%%%%%%%%%%
