%%%%%%%%%%%%%%%%%%%%
%     %     %     %%
% %%%%%% %%%%% %%% %
%                 .%
%%%%%%% %%%%%%  %%%%
%P        %        %
%%%%%%%%%%%%%%%%%%%%
