%%%%%%%%%%%%%%%%%%%%
%     %     %     %%
%% % %%%% % %%% %% %
%    %P   %    %   %
% % %% %%%%% %%%%% %
%        .%        %
%%%%%%%%%%%%%%%%%%%%
