%%%%%%%%%%%%%%%%%%%%
%    %         %   %
% %% %% % % %%%% % %
%    %  P %    %   %
%  %%%  %%% % %% % %
%   %   % . %   %  %
%%%%%%%%%%%%%%%%%%%%
