%%%%%%%%%%%%%%%%%%%%
%   %   %   %   %  %
%%  %%  % %%%  %% %%
%   %.  %   %   %  %
%%% %  %%%P%%% %% %%
%                  %
%%%%%%%%%%%%%%%%%%%%
