%%%%%%%%%%%%%%%%%%%%
%     %  P        %%
%%%% % %% %%%%%%%  %
%         %        %
%%% %  %%%% .% %% %%
%   %   %   %   %  %
%%%%%%%%%%%%%%%%%%%%
