%%%%%%%%%%%%%%%%%%%%
%     %           %%
%%%% %%%.%% %%% % %%
%     %     %     %%
%%%%  %  %%%% %% %%%
%     %     %   P %%
%%%%%%%%%%%%%%%%%%%%
