%%%%%%%%%%%%%%%%%%%%
%     %     %      %
%%% % %% % %%P% %% %
%   %   %   %   %  %
% %%%%%   %%%  % % %
%    %    %    %  .%
%%%%%%%%%%%%%%%%%%%%
