%%%%%%%%%%%%%%%%%%%%
%     %     %     %%
%%%% % %% %%%%%%%  %
%         %        %
%%% %%% %%%%% %%%%%%
%          .      P%
%%%%%%%%%%%%%%%%%%%%
