%%%%%%%%%%%%%%%%%%%%
%     P            %
%% %%% %% % %%%%%% %
%    %    %    %   %
%%% %%%  %%% % %%  %
%    %  . %    %   %
%%%%%%%%%%%%%%%%%%%%
