%%%%%%%%%%%%%%%%%%%%
%   %   %   %   %  %
%%% %  %%%%.%%% %% %
%         %        %
% %%% % %% %%%  %% %
%   %   %   %  P%  %
%%%%%%%%%%%%%%%%%%%%
