%%%%%%%%%%%%%%%%%%%%
%                  %
%%  %%%%%%%%%%%%%%%%
%                  %
%%% %%%%% %%% %%%%.%
%   P%    %    %   %
%%%%%%%%%%%%%%%%%%%%
