%%%%%%%%%%%%%%%%%%%%
%    %    %    %   %
%%% %%  %%% %%%%  %%
%    %    %    %   %
% % %%% %%% %%%  %%%
%  .  P   %        %
%%%%%%%%%%%%%%%%%%%%
