%%%%%%%%%%%%%%%%%%%%
%    %    %  P %   %
%% %%  %%%%%%% %%% %
%         %        %
%%%%%%%%% % %%%%%% %
%               .  %
%%%%%%%%%%%%%%%%%%%%
