%%%%%%%%%%%%%%%%%%%%
%  . %    % P  %   %
%% % % %%%% %%%%%% %
%         %        %
%%% %% %%%%%%%% %%%%
%                  %
%%%%%%%%%%%%%%%%%%%%
