%%%%%%%%%%%%%%%%%%%%
%    %    %    %.  %
% %% %  % %%% %%%% %
%   %   %   %   %  %
%%  % % %%  % % %% %
%   %   %   % P    %
%%%%%%%%%%%%%%%%%%%%
