%%%%%%%%%%%%%%%%%%%%
%    %    %    %   %
% %%% % % %% %% % %%
%  .  %     %     %%
%%% % %%% %P% %%%% %
%         %    %   %
%%%%%%%%%%%%%%%%%%%%
