%%%%%%%%%%%%%%%%%%%%
%         % P      %
% %% %%%%%% %%%%% %%
%           %     %%
%%% %%%%%% %  %%%%%%
%     .   %        %
%%%%%%%%%%%%%%%%%%%%
