%%%%%%%%%%%%%%%%%%%%
%       %   %   %  %
% % %%  %%  % % %% %
%   %   %   %   %  %
%%% %%P% %% %%  %  %
% .  %    %    %   %
%%%%%%%%%%%%%%%%%%%%
