%%%%%%%%%%%%%%%%%%%%
%                  %
% %% %% % %%% %%% %%
%   %   %   %   %P %
%%  %% %%  %%% %% %%
%     % .   %     %%
%%%%%%%%%%%%%%%%%%%%
