%%%%%%%%%%%%%%%%%%%%
%         %    %   %
% % %% %% %% %%%%% %
%    %  . %    %   %
%  %%%%%%  %%% % % %
%   P %     %     %%
%%%%%%%%%%%%%%%%%%%%
