%%%%%%%%%%%%%%%%%%%%
%     %     %     %%
%%%  %%% %%%%%.%% %%
%     %     %P    %%
%  %%%  %%% % %%% %%
%   %   %   %   %  %
%%%%%%%%%%%%%%%%%%%%
