%%%%%%%%%%%%%%%%%%%%
%    %P   %    %   %
%% %%%% %%% %% %%% %
%  .  %     %     %%
% % % %%%% %%%% %  %
%   %       %   %  %
%%%%%%%%%%%%%%%%%%%%
