%%%%%%%%%%%%%%%%%%%%
%    %    %    %   %
%%%  %%% %% %%%% % %
%     %   . %     %%
% %% %%%% %%% %%%% %
%       P %        %
%%%%%%%%%%%%%%%%%%%%
