%%%%%%%%%%%%%%%%%%%%
%         %        %
%%%%%%%  %%%%% % %%%
%         %   P.   %
%%% % %%%%% %  %%%%%
%     %     %     %%
%%%%%%%%%%%%%%%%%%%%
