%%%%%%%%%%%%%%%%%%%%
%                  %
%%%%% %%% %%  %%%%%%
%     %     %     %%
%%% %  %%% %% %%%% %
%.  %P  %   %   %  %
%%%%%%%%%%%%%%%%%%%%
