%%%%%%%%%%%%%%%%%%%%
%                  %
%%%%% %%  %%%%% %%%%
%     %     %     %%
% % %% %. %%%%% %  %
%   %   %   %   %P %
%%%%%%%%%%%%%%%%%%%%
