%%%%%%%%%%%%%%%%%%%%
%     %     %     %%
% % %%%%%% %%% %%%%%
%   P              %
% %%%% %%%%%%% %% %%
%   .%    %    %   %
%%%%%%%%%%%%%%%%%%%%
