%%%%%%%%%%%%%%%%%%%%
%     %     %.    %%
% %%% % %%% %%%%% %%
%    %    %    %   %
%%%  %%% %%%% %%%  %
%         %      P %
%%%%%%%%%%%%%%%%%%%%
