%%%%%%%%%%%%%%%%%%%%
%   %   %   % P %  %
% % % %%%  %%%% %  %
%   % . %       %  %
% % %%% %%  %%  %  %
%   %       %   %  %
%%%%%%%%%%%%%%%%%%%%
