%%%%%%%%%%%%%%%%%%%%
%   %   %   %   %  %
% %%%%P %%  % % %% %
%   %  .%   %   %  %
%%  % %%% % % %%% %%
%     %     %     %%
%%%%%%%%%%%%%%%%%%%%
