%%%%%%%%%%%%%%%%%%%%
%   %   %   %   %  %
%%% % % %%% %%  %  %
%   %   %.  %   %  %
% %%%%%  %% % %  % %
%    %    %    %  P%
%%%%%%%%%%%%%%%%%%%%
