%%%%%%%%%%%%%%%%%%%%
%         %    %   %
%% % %  %%% %%%%%% %
%.   %    %    %   %
%%  %% % %%%%% % % %
%    %  P %    %   %
%%%%%%%%%%%%%%%%%%%%
