%%%%%%%%%%%%%%%%%%%%
%     %     %     %%
%%% % %%.%% %  %%%%%
% P   %     %     %%
% % %%%%%  %% %% %%%
%           %     %%
%%%%%%%%%%%%%%%%%%%%
