%%%%%%%%%%%%%%%%%%%%
%   %       %   %  %
% %%   %%%  %%% %% %
%   P%    %    %   %
%%%  % %% % %.%% % %
%    %    %    %   %
%%%%%%%%%%%%%%%%%%%%
