%%%%%%%%%%%%%%%%%%%%
%    %    %    %   %
%%%%  %%% %  %.%%% %
%     %     %     %%
%% % %% %%  %P%% %%%
%    %    %    %   %
%%%%%%%%%%%%%%%%%%%%
