%%%%%%%%%%%%%%%%%%%%
%                  %
%%%%%%%% %%%% %%%% %
%         %       .%
%%% P %%%% % % %%% %
%   %   %   %   %  %
%%%%%%%%%%%%%%%%%%%%
