%%%%%%%%%%%%%%%%%%%%
%                  %
% % %% %%%% %%% % %%
%   %   %   %   %  %
%% %% % %%  % % %  %
% . %P  %   %   %  %
%%%%%%%%%%%%%%%%%%%%
