%%%%%%%%%%%%%%%%%%%%
%          .       %
% %%%%%%%% %%%%%%%%%
%P                 %
%  %% %%% %%%%% % %%
%   %   %   %   %  %
%%%%%%%%%%%%%%%%%%%%
