%%%%%%%%%%%%%%%%%%%%
%                  %
% %%%%% %%%  % %%% %
% . %  P%   %   %  %
% % %% %% % % %% % %
%     %     %     %%
%%%%%%%%%%%%%%%%%%%%
