%%%%%%%%%%%%%%%%%%%%
% .       %        %
%%  %%%%%%%  %%%% %%
%     %   P %     %%
%  %% %%% % % % % %%
%   %       %   %  %
%%%%%%%%%%%%%%%%%%%%
