%%%%%%%%%%%%%%%%%%%%
%     %     %     %%
%%% % %%% %% %% %%%%
%         %        %
%% % %%%%%%%%%%% % %
%  .   P  %        %
%%%%%%%%%%%%%%%%%%%%
