%%%%%%%%%%%%%%%%%%%%
%     %     %     %%
%  %% %%% P%% %%%% %
%   %   %   %   %  %
% %%%% %%  %% %%%% %
%   .     %        %
%%%%%%%%%%%%%%%%%%%%
