%%%%%%%%%%%%%%%%%%%%
%         %    %   %
%  %% %%% %%%% % % %
%   %   %   %P  %  %
%  %%.%%% % %%  %% %
%    %    %    %   %
%%%%%%%%%%%%%%%%%%%%
