%%%%%%%%%%%%%%%%%%%%
%         %        %
%%%   %%%%% % %%%% %
%P  %   %   %   %  %
%  %% %%%  %%%% %  %
%  .  %     %     %%
%%%%%%%%%%%%%%%%%%%%
