%%%%%%%%%%%%%%%%%%%%
%   %   %   %   %  %
%  %%  %%  %% % %% %
%   %  P% . %   %  %
%%  % % % % %% %%  %
%    %    %    %   %
%%%%%%%%%%%%%%%%%%%%
