%%%%%%%%%%%%%%%%%%%%
%    %    %    %   %
%  %%%  %%% %%% %% %
%   %   %       %  %
%%P% % % %% %  %% %%
%           %    .%%
%%%%%%%%%%%%%%%%%%%%
