%%%%%%%%%%%%%%%%%%%%
%     %  .  %     %%
% % %% %%%  % % %% %
%   %   %   %   % P%
%% %%% %%%%  % %% %%
%         %        %
%%%%%%%%%%%%%%%%%%%%
