%%%%%%%%%%%%%%%%%%%%
%    %         % . %
% %%%%% % % %%%%%  %
%     P   %        %
% % %% %% %%%%  %% %
%   %   %   %   %  %
%%%%%%%%%%%%%%%%%%%%
