%%%%%%%%%%%%%%%%%%%%
%   %  .%   %   %  %
%% % %%  % %%% %%% %
%    %         % P %
%%% %% % %%%% %%% %%
%         %        %
%%%%%%%%%%%%%%%%%%%%
