%%%%%%%%%%%%%%%%%%%%
%     P            %
% % %%%%%.% %%%% %%%
%    %    %    %   %
%% % %%%% %%% %%% %%
%         %        %
%%%%%%%%%%%%%%%%%%%%
