%%%%%%%%%%%%%%%%%%%%
% P .     %        %
% %% %% %%% %%% %% %
%   %   %   %   %  %
%% %%% %%%  %%  %% %
%     %     %     %%
%%%%%%%%%%%%%%%%%%%%
