%%%%%%%%%%%%%%%%%%%%
%   %       %.  %  %
%% %%% %%%%  % %% %%
%        P%        %
%% %%%%%% %%%%%  %%%
%         %        %
%%%%%%%%%%%%%%%%%%%%
