%%%%%%%%%%%%%%%%%%%%
%     %     %     %%
%%%%% %% %%%%% % %%%
%                  %
%%%% %%%%%%%%%%%%% %
%  .    P          %
%%%%%%%%%%%%%%%%%%%%
