%%%%%%%%%%%%%%%%%%%%
%   %   %       % P%
%%% %% %% %%%% %%% %
%         %        %
%% %% % %%%%%% %  %%
%   .%    %    %   %
%%%%%%%%%%%%%%%%%%%%
