%%%%%%%%%%%%%%%%%%%%
%    %    %    %   %
%  %%%% %%% %%  %% %
%     %     %     %%
%%%  %%%% % P%%%  %%
%    %    %    %.  %
%%%%%%%%%%%%%%%%%%%%
