%%%%%%%%%%%%%%%%%%%%
%         %        %
% %%%%%%%.% %%%% %%%
%     %     %     %%
%% %% %% %%%%% %%%%%
%                P %
%%%%%%%%%%%%%%%%%%%%
