%%%%%%%%%%%%%%%%%%%%
%    %    %    % . %
%%% %% % %%%%% %%  %
%     %     %  P  %%
%%% %%%  %%%%  % %%%
%    %    %    %   %
%%%%%%%%%%%%%%%%%%%%
