%%%%%%%%%%%%%%%%%%%%
%     %     % P   %%
% %%% %%%% %% % %%%%
%         %        %
%%%.% %%% %%%  %%% %
%   %   %       %  %
%%%%%%%%%%%%%%%%%%%%
