%%%%%%%%%%%%%%%%%%%%
%    P%     %     %%
%%% % %  % %%%% % %%
%   %   %   %   % .%
%%% %%  %%% %  %%% %
%   %   %       %  %
%%%%%%%%%%%%%%%%%%%%
