%%%%%%%%%%%%%%%%%%%%
%    %    %    %   %
% %%%%%%% % %% % %%%
% .       %        %
%%%% %%  %%%%%% %% %
%     %  P  %     %%
%%%%%%%%%%%%%%%%%%%%
