%%%%%%%%%%%%%%%%%%%%
%   %   %   %   %  %
%%%  %% % %%%%% % %%
%     %     %     %%
%% %%% % %%%%%   %%%
%    %    %  P.%   %
%%%%%%%%%%%%%%%%%%%%
