%%%%%%%%%%%%%%%%%%%%
%   %   %   %   %  %
%  %%%% %%% %%  %% %
%  P      %        %
%  %%%%%%%%% %%%%%%%
%  .      %        %
%%%%%%%%%%%%%%%%%%%%
