%%%%%%%%%%%%%%%%%%%%
%.    %     %     %%
%  %%%% %%%%% %%%%%%
%      P           %
% %%%%%% %%% % %%%%%
%     %     %     %%
%%%%%%%%%%%%%%%%%%%%
