%%%%%%%%%%%%%%%%%%%%
%   %   %   %   %  %
% % %% %%% %%%  %% %
%         %     .  %
%%%% %%%%%%% %%%%% %
%             P    %
%%%%%%%%%%%%%%%%%%%%
