%%%%%%%%%%%%%%%%%%%%
%    %    %   .%   %
%%% P%% %%%%%% % % %
%         %        %
%%%%%% %%%%% %%% %%%
%                  %
%%%%%%%%%%%%%%%%%%%%
