%%%%%%%%%%%%%%%%%%%%
%    %    %    %   %
%  %%%% % %  %%%%% %
%    %    %    %  .%
%% %%%%% %%% %%%%P%%
%                  %
%%%%%%%%%%%%%%%%%%%%
