%%%%%%%%%%%%%%%%%%%%
%                  %
% %%%% %%%%% %%%%% %
%         %   P    %
%%% %%  % %%% %%%  %
%   %   %  .%   %  %
%%%%%%%%%%%%%%%%%%%%
