%%%%%%%%%%%%%%%%%%%%
%    %    %    %   %
%%% %% %%%%  %%%%%P%
%                  %
%% %%% %%%% %%  % %%
%   %   %   %  .%  %
%%%%%%%%%%%%%%%%%%%%
