%%%%%%%%%%%%%%%%%%%%
%    %    %    %   %
% %% %%%% % %%   %%%
%   .P%     %     %%
%% %% %%% %% % %%%%%
%         %        %
%%%%%%%%%%%%%%%%%%%%
