%%%%%%%%%%%%%%%%%%%%
%               .  %
%%%%% %%%%%%%% %%%%%
%                  %
%%%%%%%%%%%%%%%%%% %
% P                %
%%%%%%%%%%%%%%%%%%%%
