%%%%%%%%%%%%%%%%%%%%
%         %        %
% %%%%% % %%%  % %%%
%    %    %    %P .%
% %% %% %% %% %% % %
%   %   %   %   %  %
%%%%%%%%%%%%%%%%%%%%
