%%%%%%%%%%%%%%%%%%%%
%                  %
%%%%.%%%%P% % %%% %%
%    %    %    %   %
%%%% % %%%%%% % % %%
%                  %
%%%%%%%%%%%%%%%%%%%%
