%%%%%%%%%%%%%%%%%%%%
%     %  P  %     %%
%% %%%% %%%%%.%%% %%
%         %        %
%%%%%% %%%%%%%%%%  %
%                  %
%%%%%%%%%%%%%%%%%%%%
