%%%%%%%%%%%%%%%%%%%%
%    %    %    %   %
% %%%% %%%%% %%%%% %
%                  %
% %%% %%% %%%%% %% %
%   %.  %   %P  %  %
%%%%%%%%%%%%%%%%%%%%
