%%%%%%%%%%%%%%%%%%%%
%         %        %
%%%% %%%%P%%%%% % %%
%.    %     %     %%
% % %%%%%% %%%%%% %%
%     %     %     %%
%%%%%%%%%%%%%%%%%%%%
