%%%%%%%%%%%%%%%%%%%%
%       %   %   % .%
%  %%%% % %%%% % % %
%   P %     %      %
% %%% % %%% % %%%  %
%    %    %    %   %
%%%%%%%%%%%%%%%%%%%%
