%%%%%%%%%%%%%%%%%%%%
%  P%   %   %   %  %
%% %%% %% %% %% % %%
%                  %
%%% %%%%%.%%% %%%%%%
%     %     %     %%
%%%%%%%%%%%%%%%%%%%%
