%%%%%%%%%%%%%%%%%%%%
%           %   P %%
%%%% % %%%  % %% %%%
%    %    %    %   %
%% %%%. %%% %%%%% %%
%         %        %
%%%%%%%%%%%%%%%%%%%%
