%%%%%%%%%%%%%%%%%%%%
%                  %
%%%%%%% %%%%% %%%% %
%     P  .%        %
% %%%% %%%  %%%%% %%
%     %     %     %%
%%%%%%%%%%%%%%%%%%%%
