%%%%%%%%%%%%%%%%%%%%
%                  %
% %%% %%% %%%  %% %%
%    %    %    %   %
% %%%%%%% %%% %%%% %
% P       %     .  %
%%%%%%%%%%%%%%%%%%%%
