%%%%%%%%%%%%%%%%%%%%
%            P     %
% %%%%%% %%%%% %%%%%
%     %     %     %%
% %%   %%% % %%%%  %
%    %.   %    %   %
%%%%%%%%%%%%%%%%%%%%
