%%%%%%%%%%%%%%%%%%%%
%   %   %.  %   %  %
%%%  %% %% %% %%%% %
%      P           %
%%  %% %%%%%%% % % %
%    %    %    %   %
%%%%%%%%%%%%%%%%%%%%
