%%%%%%%%%%%%%%%%%%%%
%              .   %
%% %%% %%% % %%%%% %
%   P%    %    %   %
% % %%%% %%% %%%% %%
%                  %
%%%%%%%%%%%%%%%%%%%%
