%%%%%%%%%%%%%%%%%%%%
%P   %    %    %   %
%  %%%  %%% % %  % %
%   %  .%   %   %  %
%% %%%%  %%   %%% %%
%         %        %
%%%%%%%%%%%%%%%%%%%%
