%%%%%%%%%%%%%%%%%%%%
%   %   %   %   %  %
% %%%% %%%% %%% % %%
%        P         %
%%  %%%% %%%% %%%%%%
%    .%     %     %%
%%%%%%%%%%%%%%%%%%%%
