%%%%%%%%%%%%%%%%%%%%
%    %    %    %   %
%%P% %%%% % % %%%% %
%     % .   %     %%
% % %%%%%% %%%%  %%%
%                  %
%%%%%%%%%%%%%%%%%%%%
