%%%%%%%%%%%%%%%%%%%%
%     %     %     %%
%%%% %%%%%% %% %%% %
%           .      %
%% %%%%%%%%%%%%%%P%%
%                  %
%%%%%%%%%%%%%%%%%%%%
