%%%%%%%%%%%%%%%%%%%%
%     %P    %     %%
%%  %%%%% %%% % %%%%
%         %        %
%% %%%%%%%%%%% %%%%%
%     .            %
%%%%%%%%%%%%%%%%%%%%
