%%%%%%%%%%%%%%%%%%%%
%.   %    %P   %   %
%% % %  %%%  %%%% %%
%         %    %   %
%%%  %% %%% % %%%% %
%   %       %   %  %
%%%%%%%%%%%%%%%%%%%%
