%%%%%%%%%%%%%%%%%%%%
%     %  P  %     %%
%%%% %% %% %%% % %%%
%                  %
%%% %%%%% %%% % %%%%
%         %.       %
%%%%%%%%%%%%%%%%%%%%
