%%%%%%%%%%%%%%%%%%%%
%  .      %        %
%%%  %%% %%%%% % %%%
%     %           %%
%%  %%% % %%% % %P%%
%   %   %   %   %  %
%%%%%%%%%%%%%%%%%%%%
