%%%%%%%%%%%%%%%%%%%%
%    %         %   %
%%%  % % %%  %%%%% %
%    %    %.   %   %
%% %%%% %%% %%%% % %
%       P %        %
%%%%%%%%%%%%%%%%%%%%
