%%%%%%%%%%%%%%%%%%%%
%         %  .     %
%%  % %%%%% % %%%% %
%P  %       %   %  %
%% %% %% %% %% %% %%
%     %     %     %%
%%%%%%%%%%%%%%%%%%%%
