%%%%%%%%%%%%%%%%%%%%
%         %P .     %
%% %%%% % %%%%  %%%%
%     %     %     %%
%% % %%% %% %% % % %
%    %    %    %   %
%%%%%%%%%%%%%%%%%%%%
