%%%%%%%%%%%%%%%%%%%%
%           %     %%
% % %%% % %%%% % %%%
%     %P    %     %%
%%  %% %% % %%  % %%
% . %   %   %   %  %
%%%%%%%%%%%%%%%%%%%%
