%%%%%%%%%%%%%%%%%%%%
%   %   %   %   %  %
%%  % %%% %%%% %%  %
%.        %        %
%%% %%%%%%%%%%%% % %
%          P       %
%%%%%%%%%%%%%%%%%%%%
