%%%%%%%%%%%%%%%%%%%%
%     %           %%
% % % %%% %%%%% % %%
%   %   %   %   %  %
% %%%  %%%  % %%% %%
%     % .   %P    %%
%%%%%%%%%%%%%%%%%%%%
