%%%%%%%%%%%%%%%%%%%%
%    P             %
%% %%% %%% %%% %%% %
%   %   %   % . %  %
%%  % %%% % % %%%% %
%   %   %   %   %  %
%%%%%%%%%%%%%%%%%%%%
