%%%%%%%%%%%%%%%%%%%%
%                  %
%%%%%%%% % %%%%%%%%%
% P                %
%  %%%%%%% %%%%% %%%
%     %.    %     %%
%%%%%%%%%%%%%%%%%%%%
